ID,LEVEL1,LEVEL2,LEVEL3,LEVEL4,LEVEL5,LEVEL6,LEVEL7,LEVEL8,LEVEL9,LEVEL10,LEVEL11,LEVEL12,LEVEL13,LEVEL14,LEVEL15,LEVEL16,LEVEL17,LEVEL18,LEVEL19,LEVEL20,LEVEL21,LEVEL22,LEVEL23,LEVEL24,LEVEL25,LEVEL26,LEVEL27,LEVEL28,LEVEL29,LEVEL30,LEVEL31,LEVEL32,LEVEL33,LEVEL34,LEVEL35,LEVEL36,LEVEL37,LEVEL38,LEVEL39,LEVEL40,LEVEL41,LEVEL42,LEVEL43,LEVEL44,LEVEL45,LEVEL46,LEVEL47,LEVEL48,LEVEL49,LEVEL50
1,10,21,33,46,60,75,91,108,126,127,0,0,0,0,0,0,0,0,0,0,0,0,0,0,0,0,0,0,0,0,0,0,0,0,0,0,0,0,0,0,0,0,0,0,0,0,0,0,0,0
2,10,21,33,46,60,75,91,108,126,145,165,186,208,231,255,280,306,333,361,362,0,0,0,0,0,0,0,0,0,0,0,0,0,0,0,0,0,0,0,0,0,0,0,0,0,0,0,0,0,0
3,10,21,33,46,60,75,91,108,126,145,165,186,208,231,255,280,306,333,361,390,420,451,483,516,550,585,621,658,696,697,0,0,0,0,0,0,0,0,0,0,0,0,0,0,0,0,0,0,0,0
4,30,60,100,150,200,300,301,0,0,0,0,0,0,0,0,0,0,0,0,0,0,0,0,0,0,0,0,0,0,0,0,0,0,0,0,0,0,0,0,0,0,0,0,0,0,0,0,0,0,0
5,20,40,60,80,100,120,140,160,180,200,220,240,260,280,300,320,340,360,380,400,420,440,460,480,500,520,540,560,580,600,620,640,660,680,700,720,740,760,780,800,820,840,860,880,900,920,940,960,980,1000
6,12,24,36,48,60,72,84,96,108,120,132,144,156,168,180,192,204,216,228,240,252,264,276,288,300,312,324,336,348,360,372,384,396,408,420,432,444,456,468,480,492,504,516,528,540,552,564,576,588,600
7,1,0,0,0,0,0,0,0,0,0,0,0,0,0,0,0,0,0,0,0,0,0,0,0,0,0,0,0,0,0,0,0,0,0,0,0,0,0,0,0,0,0,0,0,0,0,0,0,0,0
8,2160,4320,6480,8640,10800,12960,15120,17280,19440,21600,23760,25920,28080,30240,32400,34560,36720,38880,41040,43200,45360,47520,49680,51840,54000,56160,58320,60480,62640,64800,66960,69120,71280,73440,75600,77760,79920,82080,84240,86400,88560,90720,92880,95040,97200,99360,101520,103680,105840,108000
